[
  {
    "type": "palette",
    "id": "tomb",
    "terrain": {
      ".": "t_rock_floor",
      " ": [ [ "t_grass_dead", 15 ], [ "t_dirt", 4 ], [ "t_dirtmound", 3 ], [ "t_rock_floor_no_roof", 4 ] ],
      "T": "t_tree_dead",
      "R": "t_railroad_rubble",
      "S": "t_shrub",
      "<": "t_slope_up",
      ">": "t_slope_down",
      "#": "t_rock"
    },
    "furniture": { "H": "f_altar", "C": "f_coffin_c" },
    "items": {
      "H": { "item": "xedrawood_forest_tomb_artifact", "chance": 100 },
      "¢": { "item": "xedrawood_forest_tomb_artifact_worn", "chance": 33 }
    },
    "monster": { "x": { "monster": "mon_skeleton_animated", "chance": 50 }, "Z": { "monster": "mon_darkman", "chance": 100 } }
  },
  {
    "type": "palette",
    "id": "tomb_roof",
    "terrain": { ".": "t_rock_roof", " ": "t_open_air", ">": "t_slope_down" }
  },
  {
    "type": "mapgen",
    "om_terrain": [ "forest_tomb" ],
    "//": "Ground level - Z-0.",
    "object": {
      "fill_ter": "t_rock_floor",
      "rows": [
        "                  S     ",
        "            S           ",
        "   S                    ",
        "                    S   ",
        "        S               ",
        "   S            S       ",
        "   ##<###############   ",
        "   ##################   ",
        " S ####C.##>>##..C###   ",
        "   ###x..........###<S  ",
        "   ###...##..##..C###   ",
        "   ###.####..########   ",
        "   ###..###..x..#####   ",
        "   ###..C##..#...R### S ",
        "  S####R###..########   ",
        "   ########..###<####   ",
        "          TRRT     S    ",
        "     S     RR           ",
        "          TRRT       S  ",
        "      S    RR           ",
        "          TRRT          ",
        "            R    S      ",
        "    S      R            ",
        "           R    S       "
      ],
      "palettes": [ "tomb" ]
    }
  },
  {
    "type": "mapgen",
    "om_terrain": [ "forest_tomb_bottom" ],
    "//": "Underground level - Z -1.",
    "object": {
      "fill_ter": "t_rock_floor",
      "rows": [
        "########################",
        "##C..C##################",
        "##..x..#################",
        "##Cx...#################",
        "######.#################",
        "######.R################",
        "######.####.......######",
        "######.####..###.x######",
        "#####C..C##<<##R.C######",
        "#######.###..###########",
        "#######..x..############",
        "###########..###########",
        "###########..###########",
        "########################",
        "###########..###########",
        "###########......#######",
        "###########.############",
        "########C......C########",
        "########........########",
        "########...HZ...########",
        "########R......R########",
        "########################",
        "########################",
        "########################"
      ],
      "palettes": [ "tomb" ]
    }
  },
  {
    "type": "mapgen",
    "om_terrain": [ "forest_tomb_roof" ],
    "//": "Roof level - Z +1.",
    "object": {
      "rows": [
        "                        ",
        "                        ",
        "                        ",
        "                        ",
        "                        ",
        "                        ",
        "   ..>...............   ",
        "   ..................   ",
        "   ..................   ",
        "   .................>   ",
        "   ..................   ",
        "   ..................   ",
        "   ..................   ",
        "   ..................   ",
        "   ..................   ",
        "   .............>....   ",
        "                        ",
        "                        ",
        "                        ",
        "                        ",
        "                        ",
        "                        ",
        "                        ",
        "                        "
      ],
      "palettes": [ "tomb_roof" ]
    }
  }
]
